# # ###E##### #
      #       #
# # # #######  
# #           #
# #############
# #           #
# #  # ###### #
# # ## #    #  
# # ## # # ## #
# #  # # # ## #
# #### # #    #
#      # #### #
 # ## ## #  #  
 ## ###  # ####
              S